NO ./textures/no.png
SO ./textures/so.png
WE ./textures/we.png
EA ./textures/ea.png

F 220,100,0
C 225,30,0

111111111111111111111111111111111
100000000000000000000000111111111
110000000000000000000000111111111
100000000000000000000000111100001
111111111000000000000000000000001
100000000000000000000000000001111
10000000000000E100000000000011111
100000000000000000000000000011111
100000000000000000000000000011111
100000000000000000000000000011111
100000000000000000010100000011111
110000011101010111110111101011111
111101111111011111011110100011111
111111111111111111111111111111111
