NO ../textures/no.png
SO ../textures/so.png
WE ../textures/we.png
EA ../textures/ea.png

F 220,100,0
C 225,30,0

11111111111111111111111111111
11110000000000000000000001001
11110000000000000000000001001
11110000000000000000000001001
11110000000000000000000001001
11110000000000000000000001001
11110000000000000000000001001
11110000000000000000000001001
11110000000000000000000001001
11110000000000000000000001001
11110000000000000000000001001
11110000000000000000000001001
11110000000000000000000001001
11110000000000000000000001001
11110000000000000000000001001
11110000000000000000000001001
11110000000000000000000001001
11110000000000000000000001001
11110000000000000000000001001
11110000000000000000000001001
11110000000000000000000001001
11110000000000000000000001001
11110000000000010000000001001
11110000000000000000000001001
111100000000010N0100000001001
11110000000000000000000001001
11110000000000010000000001001
11110000000000000000000001001
11110000000000000000000001001
11110000000000000000000001001
11110000000000000000000001001
11110000000000000000000001001
11110000000001000000000001001
11110000000000000000010010001
1100000011010111100000010001
10000000000001111100000010001
10000000000000001101010010001
11000001110101011111011111111
11110111111101011101111010001
11111111111111111111111111111
