NO ../textures/no.png
SO ../textures/so.png
WE ../textures/we.png
EA ../textures/ea.png

F 220,100,0
C 225,30,0

11111111111111111111111111111
11110000000000000000000001001
11110000000000000000000001001
11110000000000000000000001001
11110000000000000000000001001
11110000000000000000000001001
11110000000000000000000001001
11110000000000000000000001001
11110000000000000000000001001
11110000000000000000000001001
11110000000000000000000001001
11110000000000000000000001001
11110000000000000000000001001
11110000000000000000000001001
11110000000000000000000001001
11110000000000000000000001001
11110000000000000000000001001
11110000000000000000000001001
11110000000000000000000001001
11110000000000000000000001001
11110000000000000000000001001
11110000000000000000000001001
11110000000000000000000001001
11110000000000000000000001001
11110000000000000000000001001
11110000000000000000000001001
11110000000000000000000001001
11110000000000000000000001001
11110000000000000000000001001
11110000000000000000000001001
11110000000000000000000001001
11110000000000000000000001001
11110000000000000000000001001
11110000000000000000010010001
11000000110101N11100000010001
10000000000001111100000010001
10000000000000001101010010001
11000001110101011111011111111
11110111111101011101111010001
11111111111111111111111111111
