NO ../textures/no.png
SO ../textures/so.png
WE ../textures/we.png
EA ../textures/ea.png

F 220,100,0
C 225,30,0

11111111111111
1S010000000011
10000000000011
10100000000011
10000000000001
11111111111111