NO ../textures/no.png
SO ../textures/so.png
WE ../textures/we.png
EA ../textures/ea.png

F 220,100,0
C 225,30,0

 11111111111111111111111111111111111111111111111111111111111111111
100000000000000000000000111111111111111111111111111111111111111111
110000000000000000000000111111111111111111111111111111111111111111
100000000000000000000000111100001111111111111111111111111111111111
11111111100000000000000000000000111111111111111111111111111111111
100000000000000000000000000001111111111111111111111111111111111111
10000000000000E100000000000011111111111111111111111111111111111111
100000000000000000000000000011111111111111111111111111111111111111
1000000000000000000000000000111111111
100000000000000000000000000011111111111111111111111111111111111111
100000000000000000010100000011111111111111111111111111111111111111
1100000111010101111101111010111111111111111111111111111111111111111111111111111111111
111101111111011111011110100011111111111111111111111111111111111111
11110111111101111101111010001111111111111111111111111111111111111
111111111111111111111111111111111111111111111111111111111111111111
